kapoor: singh bollywood khans indias raj hindi dil hindu 
berardin: raleigh bvoice berardinelli nando legeros unx reelviews cybernex sas jberardinell 
sleepaway: slashers hoopers hiker 
rathbone: edwardian karloff 
serpico: vigilantism minutesrated ghettos 
apatow: raunch farrelly romcom superbad raunchiness zombieland borat 
antiwar: regimes 
cyberpunk: dystopia dystopian bladerunner mutations serum 
ranchers: rancher oater corral townfolk 
biopics: 
afcdcfb: filmcriticcom filmfan comdirected internetreviews putman icq cinemareview iname rossanthony susangranger twotrey nsf opendocument sportsmail tagj compuserve obidos filmcritic subst rhodes misc onelist ejohnsonott blackchicks golafayette karten 
undersea: conservation explorers fishermen shipwrecked 
woodys: misdemeanors 
kickboxing: roundhouse statham lundgren damme 
mailman: listinfo robomod 
hammerstein: busby vincente astaire 
gayness: gays straights 
priesthood: vatican faiths 
kgb: ussr majestys soviets spys connerys goldfinger commies espionage condor assassinating commie stalin 
heists: 
jap: iwo 
hestons: 
vampiric: draculas vampirism stoker bloodsucking undead ghoul wolfman fang 
palestinian: palestine israelis jerusalem muslims bombings extremists 
defendant: prosecutor prosecuting defendants attorneys judicial prosecute 
bandmates: guitarists musicianship bassist concerts interviewees vocalist rappers 
silents: nitrate murnau caligari 
starsoverall: californiadate yorkdate californiamr starsstory starsperformance curtiz jims 
instalment: sequals trilogies 
bards: elizabethan branaghs 
pixars: toon cel pixar animators incredibles animatronics directionality gamers gamer nemo anthropomorphic animations 
nazism: germanys auschwitz reich hitlers semitism germans adolf gestapo socialism semitic 
fue: bueno recomiendo pel cula 
zucker: 
zhang: chinas chen liu mao 
espn: teammates teammate announcers athletes 
surfers: 
copeland: klan 
orbiting: nukes asteroid gadgetry 
swordfight: swordsman swordplay swordfights nobles feudal commoner schwarzeneggers 
apparitions: 
aviation: landings cockpit 
monogram: lugosi corrigan 
eps: cliffhangers syndication 
democrats: administrations elections klux republicans leftists constitutional democrat bushs interviewee ceos partisan congressional pentagon 
flynns: 
indemnity: noirs fatales whodunnit psychiatry gumshoe dunnit maltese 
shootist: gunsmoke jima peckinpahs 
ganster: gangland mafioso mobsters gangsta 
pastors: agnostic educators churchs apostle repentance pulpit hankie 
pows: barracks internment inmate 
crewmembers: 
mulan: 
libretto: tuneful parisian gallic 
lucio: suspiria fulci bava romeros argentos bavas giallo argento 
qaeda: osama 
takashi: japans 
vocalists: musicality 
voorhees: leatherface punisher 
extraterrestrials: astronauts extraterrestrial interstellar contamination bradbury organisms nasa pods 
yuen: choreographer cantonese expendables transporter 
servicemen: gis maj weepie usmc 
cardio: workouts beginner weeper intermediate physicians 
animes: manga anime pokemon 
lawmen: penitentiary lawman penal 
pakistan: westernized 
bogarts: bogie nuptials 
amityville: spookiness frights midnite creepers lewton unscary candyman jeepers crawly scariness 
cheyenne: apache settlers cavalry calvary 
jpeck: umbc cbloom dequina mrbrown cinematter hollywoodhotline hotline http renshaw newsweekly nuvo jahiels zookeeper prairienet mene bloomington 
yun: assasin 
rhonda: webmaster 
josey: blaxploitation southerners 
kumar: pothead 
sorcery: beasties tolkien harryhausen excalibur elves archaeological 
airliner: 
songwriting: songwriters lyricist 
stagecoach: valance beery saloon 
bombay: 
soliders: firefight 
commandant: 
scriptures: fundamentalists fundamentalism judaism judeo bibles atheism evangelical atheists theological 
swashbuckler: monarchy pageantry swashbuckling 
yakuza: 
submarines: uss 
gunslinger: gunfighter leones 
championships: undefeated tournament championship 
ringu: pyschological 
gorehound: grue gorehounds ultraviolent savini goriest gorier beheadings decapitations gorefest sexploitation reanimated 
intergalactic: spaceships galactic spaceship planetary earthlings spacecraft scifi galactica battlestar bots mutate humanoids earths humanoid androids 
hai: 
arabs: geopolitical islamic islam 
infantry: battalion commanders squadron armys jingoism jingoistic racists berets regiment 
madagascar: panda 
chans: lis shaolin stuntwork chung mandarin 
aladdin: dumbo grandaughter christmastime pinocchio tots 
vci: 
hauntings: 
shah: mein 
calidad: espa cuando hace blurays tiempo wildlife ported upscaling visto 
